===============
|      |    o |
|      |      |
|      |  ====|
|             |
|              
|             |
|             |
|           x |
====== ========