====== ========
|o     |      |
|      |      |
|===== |      |
|             |
|             |
|       x     |
|             |
|             |
===============