===============
|o     |      |
|      |      |
|===== |      |
|             |
              |
|       x     |
|             |
|             |
===============