███████████████
█      █    o █
█      █      █
█      █  █████
█             █
              █
█             █
█             █
█           x █
███████ ███████

https://www.utf8-chartable.de/unicode-utf8-table.pl
U+2500